,datetime,price,TOTAL_TRADES,TOTAL_TRADES_BUY,TOTAL_TRADES_SELL,NUMBER_OF_CONTRACTS,VOLUME,QUOTE_VOLUME,VOLUME_BUY,QUOTE_VOLUME_BUY,VOLUME_SELL,QUOTE_VOLUME_SELL
0,2023-03-12,0.9845,262819,115006,147813,247898499,247898499,239689442.50063,110952589,107406010.95187,136945910,132283431.54876
1,2023-03-13,0.99519,192625,97869,94756,272970321,272970321,270476519.5543,138553968,137311052.11387,134416353,133165467.44043
2,2023-03-14,0.99623,52152,29601,22551,67778248,67778248,67459486.31117,36144055,35974924.77801,31634193,31484561.53316
3,2023-03-15,0.99615,59609,35108,24501,61588985,61588985,61356774.45105,38098100,37955727.73275,23490885,23401046.7183
4,2023-03-16,0.99683,37181,21067,16114,48581285,48581285,48428658.42056,24555578,24481479.61827,24025707,23947178.80229
5,2023-03-17,0.99725,49664,23935,25729,68073546,68073546,67873189.36202,29827624,29743333.81154,38245922,38129855.55048
6,2023-03-18,0.99657,40509,18393,22116,38843702,38843702,38719628.12627,19290760,19229476.79643,19552942,19490151.32984
7,2023-03-19,0.99634,19177,8356,10821,10921385,10921385,10883397.97176,4805229,4788673.6565,6116156,6094724.31526
8,2023-03-20,0.99591,54988,28862,26126,43141884,43141884,42960011.28099,20701890,20615577.44954,22439994,22344433.83145
9,2023-03-21,0.99645,58807,28937,29870,31164548,31164548,31039244.78888,15774541,15711307.03155,15390007,15327937.75733
10,2023-03-22,0.99663,73396,36107,37289,22145033,22145033,22070383.75536,10647471,10612027.65379,11497562,11458356.10157
11,2023-03-23,0.99732,20432,9302,11130,12870909,12870909,12829202.47375,6259433,6239001.61637,6611476,6590200.85738
12,2023-03-24,0.99826,52017,29721,22296,23177276,23177276,23129630.84707,13651486,13623014.83751,9525790,9506616.00956
13,2023-03-25,0.99856,40252,19450,20802,18385653,18385653,18359229.70318,11109539,11094130.919,7276114,7265098.78418
14,2023-03-26,0.99851,12902,6106,6796,6290602,6290602,6281834.45946,2984470,2980273.52094,3306132,3301560.93852
15,2023-03-27,0.99884,35668,17823,17845,14922146,14922146,14903325.14102,8227593,8217113.57004,6694553,6686211.57098
16,2023-03-28,0.9989,48679,23221,25458,15559088,15559088,15545251.93792,7504013,7497306.53312,8055075,8047945.4048
17,2023-03-29,0.99918,32353,14960,17393,16217706,16217706,16202110.04764,7440244,7433281.23786,8777462,8768828.80978
18,2023-03-30,0.99942,19535,10129,9406,8901534,8901534,8894799.9256,4714478,4710850.99155,4187056,4183948.93405
19,2023-03-31,0.9992,21916,10968,10948,13362214,13362214,13353515.8746,8202199,8196856.24218,5160015,5156659.63242
20,2023-04-01,0.9988,35396,18816,16580,28141859,28141859,28096417.90512,9896778,9880732.23626,18245081,18215685.66886
21,2023-04-02,0.99886,14704,6607,8097,6780905,6780905,6773218.26819,3673942,3669814.11546,3106963,3103404.15273
22,2023-04-03,0.99918,19525,9207,10318,10774262,10774262,10764373.61747,4538128,4534016.57473,6236134,6230357.04274
23,2023-04-04,0.99908,15363,7269,8094,6599220,6599220,6593348.73204,3185116,3182306.95475,3414104,3411041.77729
24,2023-04-05,0.99917,16153,8267,7886,6422508,6422508,6416960.9337,3137967,3135283.17934,3284541,3281677.75436
25,2023-04-06,0.99896,12709,7135,5574,4121938,4121938,4118171.12134,2111160,2109270.13906,2010778,2008900.98228
26,2023-04-07,0.99873,10567,4793,5774,3406920,3406920,3403263.21732,1845089,1843113.78915,1561831,1560149.42817
27,2023-04-08,0.99896,9847,4793,5054,3140157,3140157,3136654.63151,1332486,1330955.51211,1807671,1805699.1194
28,2023-04-09,0.99886,11006,6247,4759,3398667,3398667,3394670.28378,1726281,1724297.75107,1672386,1670372.53271
29,2023-04-10,0.99889,9432,4611,4821,4225222,4225222,4220291.51289,1338181,1336621.5794,2887041,2883669.93349
30,2023-04-11,0.99856,15864,9058,6806,7060858,7060858,7051417.17696,3477714,3473058.76789,3583144,3578358.40907
31,2023-04-12,0.99877,17357,10010,7347,5430598,5430598,5422235.25632,2858843,2854435.39475,2571755,2567799.86157
32,2023-04-13,0.99847,16878,8114,8764,6373592,6373592,6363794.68863,3237548,3232581.34602,3136044,3131213.34261
33,2023-04-14,0.99848,18596,11124,7472,7538867,7538867,7527527.16169,4626874,4619864.84483,2911993,2907662.31686
34,2023-04-15,0.99855,16922,8486,8436,5670993,5670993,5662846.02537,2979060,2974759.03579,2691933,2688086.98958
35,2023-04-16,0.99879,13960,7577,6383,5094594,5094594,5087516.07266,2633242,2629594.27292,2461352,2457921.79974
36,2023-04-17,0.99866,14563,7863,6700,5440430,5440430,5433578.83767,2709735,2706280.33159,2730695,2727298.50608
37,2023-04-18,0.99919,14181,8122,6059,5487601,5487601,5482052.00752,3018003,3014924.04548,2469598,2467127.96204
38,2023-04-19,0.9991,21515,10750,10765,8668918,8668918,8660053.7396,4219595,4215256.55959,4449323,4444797.18001
39,2023-04-20,0.9994,15986,8213,7773,6063902,6063902,6058985.64668,3428425,3425673.96392,2635477,2633311.68276
40,2023-04-21,0.99957,14092,7593,6499,7604899,7604899,7601074.02539,4874030,4871543.40618,2730869,2729530.61921
41,2023-04-22,0.99939,13444,5284,8160,4900125,4900125,4897399.32221,1931588,1930572.11894,2968537,2966827.20327
42,2023-04-23,0.99951,16489,9544,6945,6192644,6192644,6188364.97262,3038285,3036221.15078,3154359,3152143.82184
43,2023-04-24,0.99939,15801,6775,9026,5584885,5584885,5581700.35156,2968015,2966326.49471,2616870,2615373.85685
44,2023-04-25,0.99923,16365,8031,8334,7176728,7176728,7172246.32613,3731719,3729417.72185,3445009,3442828.60428
45,2023-04-26,0.99908,22090,11936,10154,7953205,7953205,7947295.97085,3874115,3871190.84436,4079090,4076105.12649
46,2023-04-27,0.99914,21252,11286,9966,8468945,8468945,8461674.62633,4741136,4737004.93744,3727809,3724669.68889
47,2023-04-28,0.99869,18805,10301,8504,10472525,10472525,10460798.11235,5373878,5367503.17644,5098647,5093294.93591
48,2023-04-29,0.9987,15690,8244,7446,6535965,6535965,6527418.38812,3115231,3111121.80744,3420734,3416296.58068
49,2023-04-30,0.99901,14053,6850,7203,6385306,6385306,6377962.70375,3210992,3207295.07976,3174314,3170667.62399
50,2023-05-01,0.99928,11740,6187,5553,6146070,6146070,6140629.71903,3139440,3136558.37965,3006630,3004071.33938
51,2023-05-02,0.99902,11741,5234,6507,6643099,6643099,6637568.20941,2209990,2208214.7315,4433109,4429353.47791
52,2023-05-03,0.99928,13751,6962,6789,5233641,5233641,5229281.57826,2203902,2201994.61286,3029739,3027286.9654
53,2023-05-04,0.99907,9763,4634,5129,3703847,3703847,3700949.3376,1803422,1802003.88641,1900425,1898945.45119
54,2023-05-05,0.99865,15663,7040,8623,6305257,6305257,6298295.43636,3251067,3247408.22918,3054190,3050887.20718
55,2023-05-06,0.99762,15592,9332,6260,10171816,10171816,10152029.11664,6633392,6620341.91492,3538424,3531687.20172
56,2023-05-07,0.99829,12719,6797,5922,5979205,5979205,5966902.62737,3152668,3145998.80292,2826537,2820903.82445
57,2023-05-08,0.99854,15866,9472,6394,7020095,7020095,7008547.78619,3887747,3881186.28566,3132348,3127361.50053
58,2023-05-09,0.9989,13191,7746,5445,6228031,6228031,6220286.83022,3398927,3394568.89583,2829104,2825717.93439
59,2023-05-10,0.99873,11027,6190,4837,5895322,5895322,5888477.27718,2944855,2941339.19105,2950467,2947138.08613
60,2023-05-11,0.99896,9358,5826,3532,5239600,5239600,5234011.26931,3161281,3157867.7326,2078319,2076143.53671
61,2023-05-12,0.99887,7687,3819,3868,3177465,3177465,3174111.87066,1519506,1517860.89836,1657959,1656250.9723
62,2023-05-13,0.99899,5991,3001,2990,1614311,1614311,1612658.65341,800696,799875.10634,813615,812783.54707
63,2023-05-14,0.99892,5791,3130,2661,2781029,2781029,2778239.05181,1163659,1162442.22936,1617370,1615796.82245
64,2023-05-15,0.99909,8648,5151,3497,3998916,3998916,3995069.84562,2542276,2539802.7048,1456640,1455267.14082
65,2023-05-16,0.99918,5400,3353,2047,1710434,1710434,1708919.19348,1216376,1215303.54369,494058,493615.64979
66,2023-05-17,0.99917,9299,4598,4701,3991144,3991144,3988629.97014,2163842,2162452.9886,1827302,1826176.98154
67,2023-05-18,0.99934,14280,9979,4301,5983174,5983174,5979988.29124,3694849,3692848.70028,2288325,2287139.59096
68,2023-05-19,0.99927,8306,4739,3567,3421473,3421473,3419584.10382,1942938,1941891.20185,1478535,1477692.90197
69,2023-05-20,0.99896,8626,5229,3397,3942945,3942945,3939273.5918,1964935,1963061.91504,1978010,1976211.67676
70,2023-05-21,0.99903,5667,2620,3047,2207740,2207740,2205716.41041,1150904,1149810.28787,1056836,1055906.12254
71,2023-05-22,0.99933,6952,3251,3701,2283349,2283349,2281536.63225,1107174,1106240.46943,1176175,1175296.16282
72,2023-05-23,0.99933,9065,5075,3990,2835053,2835053,2832835.85383,1428574,1427455.18231,1406479,1405380.67152
73,2023-05-24,0.99941,8995,4277,4718,5071986,5071986,5068547.98184,2590485,2588837.27135,2481501,2479710.71049
74,2023-05-25,0.99964,14946,7545,7401,8501940,8501940,8498402.52794,5153376,5151372.23291,3348564,3347030.29503
75,2023-05-26,0.99956,8746,4475,4271,6227025,6227025,6223764.41179,4228329,4226094.71633,1998696,1997669.69546
76,2023-05-27,0.99929,9874,4390,5484,2714483,2714483,2713030.85869,1401245,1400494.21423,1313238,1312536.64446
77,2023-05-28,0.99931,7725,4246,3479,2640803,2640803,2639094.66864,962419,961784.63213,1678384,1677310.03651
78,2023-05-29,0.99933,5804,3193,2611,1804981,1804981,1803874.84601,1061663,1061002.91651,743318,742871.9295
79,2023-05-30,0.9992,7111,3244,3867,3044423,3044423,3042437.82307,1488050,1487129.82456,1556373,1555307.99851
80,2023-05-31,0.99914,16807,9194,7613,4867906,4867906,4864018.01324,2357350,2355504.54669,2510556,2508513.46655
81,2023-06-01,0.99918,20445,10176,10269,6195846,6195846,6190680.22821,3040919,3038394.91217,3154927,3152285.31604
82,2023-06-02,0.99905,17981,8616,9365,4264783,4264783,4261297.91024,2246434,2244610.9924,2018349,2016686.91784
83,2023-06-03,0.999,17225,8640,8585,3990534,3990534,3986979.51514,1989722,1987974.76357,2000812,1999004.75157
84,2023-06-04,0.99911,12775,5957,6818,3043728,3043728,3041045.73849,1528168,1526823.89328,1515560,1514221.84521
85,2023-06-05,0.9991,12168,5511,6657,2718728,2718728,2716382.21562,1343559,1342430.79185,1375169,1373951.42377
86,2023-06-06,0.99914,12938,6884,6054,3202827,3202827,3200113.5445,1782542,1781034.89707,1420285,1419078.64743
87,2023-06-07,0.99929,13597,9157,4440,3164173,3164173,3161665.43461,1667644,1666325.24004,1496529,1495340.19457
88,2023-06-08,0.99926,22635,11063,11572,3739982,3739982,3737344.34906,1708472,1707240.72885,2031510,2030103.62021
89,2023-06-09,0.99949,16924,8255,8669,4558619,4558619,4555572.31798,2673031,2671235.53067,1885588,1884336.78731
90,2023-06-10,0.99908,26555,10970,15585,10341793,10341793,10333422.94044,4692964,4689026.37648,5648829,5644396.56396
91,2023-06-11,0.99905,11663,6419,5244,3396461,3396461,3392860.32032,1692693,1690839.87112,1703768,1702020.4492
92,2023-06-12,0.99929,9728,5095,4633,2714865,2714865,2712734.46486,1261912,1260912.18776,1452953,1451822.2771
93,2023-06-13,0.99949,9654,5656,3998,2635528,2635528,2634042.17648,1326014,1325233.82615,1309514,1308808.35033
94,2023-06-14,0.99953,10413,5631,4782,3824615,3824615,3822738.73858,2010814,2009802.137,1813801,1812936.60158
95,2023-06-15,1.0008,56218,26038,30180,92072621,92072621,92251146.89083,46945582,47030730.70023,45127039,45220416.1906
96,2023-06-16,1.00078,51630,41126,10504,25781268,25781268,25811810.37297,13947800,13964754.10874,11833468,11847056.26423
97,2023-06-17,1.0003,14626,7623,7003,13444586,13444586,13452276.59872,6095387,6098898.50383,7349199,7353378.09489
98,2023-06-18,0.99994,10827,5906,4921,8285305,8285305,8285822.6568,3509190,3509470.03759,4776115,4776352.61921
99,2023-06-19,0.99974,53992,4363,49629,6448319,6448319,6447817.35787,1943323,1943183.42566,4504996,4504633.93221
100,2023-06-20,0.99954,131131,5709,125422,11604844,11604844,11602763.9071,5571494,5570545.60264,6033350,6032218.30446
101,2023-06-21,0.99946,125356,8040,117316,16539165,16539165,16530874.24468,6725966,6722681.31569,9813199,9808192.92899
102,2023-06-22,0.99929,15575,5860,9715,6407861,6407861,6404661.38888,3348762,3347149.47647,3059099,3057511.91241
103,2023-06-23,0.99906,9283,3780,5503,3811851,3811851,3809063.98675,1371115,1370145.71744,2440736,2438918.26931
104,2023-06-24,0.99906,9123,5334,3789,3598593,3598593,3595237.72792,1472836,1471477.9555,2125757,2123759.77242
105,2023-06-25,0.99914,10768,6901,3867,2319762,2319762,2317657.60302,1193713,1192648.56023,1126049,1125009.04279
106,2023-06-26,0.9993,7660,4331,3329,1543920,1543920,1542792.31163,642825,642356.41664,901095,900435.89499
107,2023-06-27,0.99937,7152,4314,2838,1279539,1279539,1278717.69016,533797,533463.95127,745742,745253.73889
108,2023-06-28,0.99957,14133,7129,7004,4557660,4557660,4555247.65442,2249904,2248773.79284,2307756,2306473.86158
109,2023-06-29,0.99972,12583,6695,5888,3814829,3814829,3813390.42638,2113182,2112422.2027,1701647,1700968.22368
110,2023-06-30,0.99966,14080,6757,7323,4977776,4977776,4976404.10628,2530785,2530113.73595,2446991,2446290.37033
111,2023-07-01,0.99956,7514,4282,3232,1876896,1876896,1876389.85554,941290,941029.25042,935606,935360.60512
112,2023-07-02,0.99956,6559,3577,2982,1331179,1331179,1330555.60688,769656,769300.75818,561523,561254.8487
113,2023-07-03,0.99947,11396,3711,7685,1547633,1547633,1546851.36651,684171,683828.69835,863462,863022.66816
114,2023-07-04,0.99927,9269,5326,3943,2282375,2282375,2280900.19525,1179624,1178874.31465,1102751,1102025.8806
115,2023-07-05,0.99939,6887,4836,2051,1327301,1327301,1326490.57875,731637,731182.30738,595664,595308.27137
116,2023-07-06,0.99949,10837,7402,3435,2237761,2237761,2236428.73719,989415,988852.99661,1248346,1247575.74058
117,2023-07-07,0.99942,13974,7046,6928,4131430,4131430,4129259.98756,1975660,1974631.37847,2155770,2154628.60909
118,2023-07-08,0.9993,11136,5182,5954,1708165,1708165,1707218.80432,916659,916191.39763,791506,791027.40669
119,2023-07-09,0.9994,4842,2552,2290,970478,970478,969847.31293,499375,499060.65879,471103,470786.65414
120,2023-07-10,0.99934,14210,5966,8244,2553134,2553134,2551748.81241,1192883,1192221.52377,1360251,1359527.28864
121,2023-07-11,0.99935,16740,8708,8032,3880704,3880704,3878573.37792,2114430,2113266.70527,1766274,1765306.67265
122,2023-07-12,0.99946,13961,6863,7098,3350367,3350367,3348620.44978,1843463,1842496.70589,1506904,1506123.74389
123,2023-07-13,0.99929,19943,9522,10421,7213483,7213483,7208862.52192,3182770,3180708.0748,4030713,4028154.44712
124,2023-07-14,0.99903,19719,9483,10236,4449483,4449483,4445915.94665,1959225,1957645.31507,2490258,2488270.63158
125,2023-07-15,0.99922,10259,4086,6173,984419,984419,983597.87486,535480,535034.51722,448939,448563.35764
126,2023-07-16,0.99893,7961,3585,4376,1583278,1583278,1581987.51214,826924,826242.64391,756354,755744.86823
127,2023-07-17,0.99927,8103,3505,4598,1261993,1261993,1261053.48512,583671,583225.43759,678322,677828.04753
128,2023-07-18,0.99938,7851,5986,1865,1304527,1304527,1303700.40248,790843,790341.56325,513684,513358.83923
129,2023-07-19,0.9994,9029,5218,3811,1883916,1883916,1882807.35541,1180344,1179634.19549,703572,703173.15992
130,2023-07-20,0.9995,4959,3041,1918,876697,876697,876229.57559,457612,457367.35753,419085,418862.21806
131,2023-07-21,0.99951,5065,2383,2682,1499496,1499496,1498817.49409,864215,863839.11055,635281,634978.38354
132,2023-07-22,0.99959,3995,2223,1772,1395318,1395318,1394632.70784,773803,773438.85605,621515,621193.85179
133,2023-07-23,0.99952,6000,2053,3947,1024494,1024494,1024011.70016,486067,485834.98092,538427,538176.71924
134,2023-07-24,0.99968,6714,3661,3053,1963135,1963135,1962490.14626,1093911,1093535.71335,869224,868954.43291
135,2023-07-25,0.99966,7126,4207,2919,1958467,1958467,1957961.08298,1571782,1571391.41961,386685,386569.66337
136,2023-07-26,0.99954,6309,2055,4254,1211216,1211216,1210818.49438,575905,575717.89931,635311,635100.59507
137,2023-07-27,0.99968,4558,1740,2818,1576610,1576610,1575938.77421,567023,566788.28769,1009587,1009150.48652
138,2023-07-28,0.99964,6169,3285,2884,1010497,1010497,1010206.41801,474326,474187.83773,536171,536018.58028
139,2023-07-29,0.99947,5544,2486,3058,1373859,1373859,1373224.69992,692791,692486.56932,681068,680738.1306
140,2023-07-30,0.99948,2747,1413,1334,731851,731851,731526.13572,429723,429536.47257,302128,301989.66315
141,2023-07-31,0.99969,4215,2448,1767,641478,641478,641230.47117,357224,357080.26996,284254,284150.20121
142,2023-08-01,1.0,6366,3750,2616,2081564,2081564,2081424.70568,1283806,1283712.19857,797758,797712.50711
143,2023-08-02,1.00009,11019,4976,6043,4209289,4209289,4209732.76211,2571235,2571554.55802,1638054,1638178.20409
144,2023-08-03,1.00056,8845,4873,3972,4818622,4818622,4821565.24775,3163263,3165173.85816,1655359,1656391.38959
145,2023-08-04,1.00137,18417,11328,7089,11939535,11939535,11951165.8636,7774546,7782516.19081,4164989,4168649.67279
146,2023-08-05,1.00064,8858,4189,4669,6107869,6107869,6114622.62153,2531766,2534603.80362,3576103,3580018.81791
147,2023-08-06,1.0011,12754,7490,5264,3606214,3606214,3609001.03668,2030880,2032435.76738,1575334,1576565.2693
148,2023-08-07,1.00085,15569,10201,5368,11384456,11384456,11400622.34397,7193448,7204126.79984,4191008,4196495.54413
149,2023-08-08,1.0,15748,9073,6675,6631445,6631445,6635635.14451,2967310,2969528.94083,3664135,3666106.20368
150,2023-08-09,0.99997,13606,8714,4892,5399291,5399291,5399643.39104,2889618,2889806.30578,2509673,2509837.08526
151,2023-08-10,1.00055,15227,7796,7431,4343668,4343668,4344834.2536,1432594,1432952.76714,2911074,2911881.48646
152,2023-08-11,1.00051,7081,3527,3554,1523566,1523566,1524709.24325,803240,803848.40311,720326,720860.84014
153,2023-08-12,1.00012,7952,5117,2835,1419673,1419673,1420242.37459,891525,891907.81232,528148,528334.56227
154,2023-08-13,1.00022,7321,3407,3914,993651,993651,993845.91412,451163,451258.24336,542488,542587.67076
155,2023-08-14,1.00054,5580,2799,2781,1197510,1197510,1198362.1478,682619,683097.48046,514891,515264.66734
156,2023-08-15,1.00051,7783,4643,3140,1689501,1689501,1690779.25686,910361,911060.5472,779140,779718.70966
157,2023-08-16,1.00073,12358,6531,5827,2878734,2878734,2880954.79718,1977813,1979388.61999,900921,901566.17719
158,2023-08-17,0.99984,22836,11183,11653,9210092,9210092,9211566.97602,4044800,4045813.77079,5165292,5165753.20523
159,2023-08-18,0.99986,15283,8034,7249,4444317,4444317,4443747.685,2176623,2176393.47625,2267694,2267354.20875
160,2023-08-19,0.99969,13725,6808,6917,2448173,2448173,2447655.81038,1272691,1272458.40371,1175482,1175197.40667
161,2023-08-20,0.99964,7990,4628,3362,1921270,1921270,1920639.87036,950416,950119.93451,970854,970519.93585
162,2023-08-21,0.99965,12753,7855,4898,3469834,3469834,3468872.30537,1381389,1381055.27472,2088445,2087817.03065
163,2023-08-22,0.99995,10065,6147,3918,2436153,2436153,2435561.98435,958612,958414.11079,1477541,1477147.87356
164,2023-08-23,0.99977,8329,4634,3695,1261408,1261408,1261283.29982,641024,640964.20679,620384,620319.09303
165,2023-08-24,0.99989,10832,5142,5690,2206463,2206463,2206217.73355,1160240,1160131.40275,1046223,1046086.3308
166,2023-08-25,1.00001,8011,3459,4552,1457062,1457062,1457091.88951,834527,834559.44198,622535,622532.44753
167,2023-08-26,1.0,11306,6042,5264,4251398,4251398,4251280.67197,1430629,1430618.16114,2820769,2820662.51083
168,2023-08-27,1.00005,7670,5447,2223,1110197,1110197,1110146.60814,737377,737341.72101,372820,372804.88713
169,2023-08-28,1.00015,21661,2988,18673,3226896,3226896,3227045.26603,1192167,1192226.93396,2034729,2034818.33207
170,2023-08-29,0.99959,12694,6556,6138,3770524,3770524,3770123.08333,1920044,1919845.8154,1850480,1850277.26793
171,2023-08-30,0.9996,9554,5735,3819,2655944,2655944,2654909.65199,1467144,1466578.08264,1188800,1188331.56935
172,2023-08-31,0.99979,9633,6954,2679,1131401,1131401,1131013.00035,587189,586983.24152,544212,544029.75883
173,2023-09-01,1.00002,6761,3525,3236,1347179,1347179,1347090.07857,590629,590582.08601,756550,756507.99256
174,2023-09-02,0.99981,7747,4908,2839,952789,952789,952716.49094,567490,567452.72378,385299,385263.76716
175,2023-09-03,0.9997,5058,2316,2742,595058,595058,594904.96691,285524,285448.99429,309534,309455.97262
176,2023-09-04,0.99984,5165,2691,2474,797348,797348,797240.70481,402875,402812.695,394473,394428.00981
177,2023-09-05,0.99994,4688,2478,2210,690309,690309,690362.13946,387680,387702.20433,302629,302659.93513
178,2023-09-06,1.00009,9751,6373,3378,921702,921702,921789.31247,509857,509903.2426,411845,411886.06987
179,2023-09-07,0.99999,7630,2943,4687,2733595,2733595,2734036.21435,1566814,1567209.21583,1166781,1166826.99852
180,2023-09-08,0.99986,7586,3809,3777,725531,725531,725491.87943,335627,335608.95461,389904,389882.92482
181,2023-09-09,0.99986,5394,2512,2882,544879,544879,544811.29983,287651,287613.63891,257228,257197.66092
182,2023-09-10,0.9999,4382,2272,2110,524867,524867,524768.24029,260016,259966.62774,264851,264801.61255
183,2023-09-11,0.99985,7869,3995,3874,910588,910588,910476.52442,418620,418571.69524,491968,491904.82918
184,2023-09-12,0.99963,6432,2807,3625,1805541,1805541,1805174.02189,1003150,1002953.58927,802391,802220.43262
185,2023-09-13,0.9996,7770,2955,4815,786446,786446,786210.15004,354323,354216.99724,432123,431993.1528
186,2023-09-14,0.99937,9119,3437,5682,900017,900017,899605.51,451195,450978.93741,448822,448626.57259
187,2023-09-15,0.99968,8235,4091,4144,2103563,2103563,2103030.49753,1048246,1047958.48262,1055317,1055072.01491
188,2023-09-16,0.99941,5573,2360,3213,765106,765106,764784.85381,344618,344470.44228,420488,420314.41153
189,2023-09-17,0.99931,4936,2599,2337,1072464,1072464,1071824.48092,311917,311737.1943,760547,760087.28662
190,2023-09-18,0.99936,8393,4613,3780,2034103,2034103,2033198.29267,1126103,1125603.39488,908000,907594.89779
191,2023-09-19,0.99938,6355,2824,3531,503614,503614,503333.55358,303267,303100.30748,200347,200233.2461
192,2023-09-20,0.99948,7494,5474,2020,685576,685576,685224.8253,238428,238302.02611,447148,446922.79919
193,2023-09-21,0.99958,6217,3559,2658,707029,707029,706667.62092,358358,358173.63298,348671,348493.98794
194,2023-09-22,0.99963,3808,1985,1823,306765,306765,306634.44022,171775,171702.68912,134990,134931.7511
195,2023-09-23,0.9995,3728,2156,1572,371427,371427,371266.51121,153106,153039.62233,218321,218226.88888
196,2023-09-24,0.99938,6324,2165,4159,1690472,1690472,1689151.28911,704839,704222.54871,985633,984928.7404
197,2023-09-25,0.99974,7695,4701,2994,696527,696527,696291.1849,433110,432957.07829,263417,263334.10661
198,2023-09-26,0.99988,5269,3154,2115,1427188,1427188,1426923.2258,824542,824375.99578,602646,602547.23002
199,2023-09-27,1.00023,9670,3952,5718,1614789,1614789,1615006.71705,753895,754015.88764,860894,860990.82941
200,2023-09-28,0.99959,8766,4049,4717,1346371,1346371,1346508.24508,536591,536673.16033,809780,809835.08475
201,2023-09-29,0.99968,9025,6112,2913,866693,866693,866400.74313,579326,579128.58082,287367,287272.16231
202,2023-09-30,0.99951,6599,2908,3691,719460,719460,719157.9742,379856,379693.28121,339604,339464.69299
203,2023-10-01,0.9997,11333,4734,6599,950921,950921,950480.38538,557913,557657.66379,393008,392822.72159
204,2023-10-02,0.99935,10645,5474,5171,1374350,1374350,1373470.90726,642669,642270.46083,731681,731200.44643
205,2023-10-03,0.99955,11486,9134,2352,723845,723845,723475.75698,377867,377672.60706,345978,345803.14992
206,2023-10-04,0.99953,9476,5117,4359,942765,942765,942315.08372,450224,450003.06329,492541,492312.02043
207,2023-10-05,0.99934,11165,6228,4937,1618726,1618726,1617746.12851,685946,685534.472,932780,932211.65651
208,2023-10-06,0.99915,9077,4484,4593,609350,609350,608930.76134,256237,256061.82808,353113,352868.93326
209,2023-10-07,0.999,6824,3056,3768,662833,662833,662214.68991,302345,302069.19554,360488,360145.49437
210,2023-10-08,0.99903,13778,7609,6169,1435908,1435908,1434364.64277,609221,608602.87242,826687,825761.77035
211,2023-10-09,0.99921,16845,12005,4840,995216,995216,994436.29435,517524,517126.52223,477692,477309.77212
212,2023-10-10,0.99935,11380,6264,5116,1198038,1198038,1197232.14159,787207,786678.15501,410831,410553.98658
213,2023-10-11,0.99969,9949,6045,3904,824503,824503,824085.41756,444928,444706.22868,379575,379379.18888
214,2023-10-12,0.99982,7862,4284,3578,723245,723245,723041.33266,411216,411104.37283,312029,311936.95983
215,2023-10-13,0.99967,6863,3383,3480,720457,720457,720333.36543,379948,379886.11254,340509,340447.25289
216,2023-10-14,0.99952,7770,1788,5982,518907,518907,518696.75083,251749,251649.33298,267158,267047.41785
217,2023-10-15,0.99938,9588,5392,4196,2532953,2532953,2527874.06876,1343369,1339331.34552,1189584,1188542.72324
218,2023-10-16,0.99914,13972,6165,7807,1526768,1526768,1525653.88249,557630,557239.56455,969138,968414.31794
219,2023-10-17,0.9992,13509,7063,6446,1290126,1290126,1288931.09784,672949,672334.44544,617177,616596.6524
220,2023-10-18,0.99923,7651,4140,3511,754395,754395,753780.26246,503081,502671.83223,251314,251108.43023
221,2023-10-19,0.99917,6352,3034,3318,880889,880889,880267.17236,510503,510140.73454,370386,370126.43782
222,2023-10-20,0.9994,14746,5562,9184,7718898,7718898,7715666.96498,5264741,5262631.17854,2454157,2453035.78644
223,2023-10-21,0.9993,14176,8915,5261,1279917,1279917,1279275.59678,602144,601846.71328,677773,677428.8835
224,2023-10-22,0.9995,17733,8680,9053,1104262,1104262,1103593.37195,592988,592618.16047,511274,510975.21148
225,2023-10-23,0.99928,14703,8456,6247,3140249,3140249,3137851.86927,1789336,1787971.97043,1350913,1349879.89884
226,2023-10-24,0.99957,18627,8766,9861,3752483,3752483,3750620.13987,1735084,1734241.59671,2017399,2016378.54316
227,2023-10-25,0.99928,13917,6576,7341,1321076,1321076,1320410.19118,599001,598697.50494,722075,721712.68624
228,2023-10-26,0.99939,12864,8598,4266,1569031,1569031,1568206.10377,969973,969454.22168,599058,598751.88209
229,2023-10-27,0.99953,10948,7928,3020,1257905,1257905,1257267.72615,383033,382832.06845,874872,874435.6577
230,2023-10-28,0.99934,6539,3187,3352,1050749,1050749,1050177.03688,668046,667683.78193,382703,382493.25495
231,2023-10-29,0.99939,8608,4425,4183,1958993,1958993,1958022.97088,1091642,1091165.13856,867351,866857.83232
232,2023-10-30,0.99915,11051,6234,4817,3429851,3429851,3427591.07448,2533985,2532366.07778,895866,895224.9967
233,2023-10-31,0.99909,8916,5298,3618,1430695,1430695,1429491.47755,551031,550565.11559,879664,878926.36196
234,2023-11-01,0.99912,8125,4388,3737,1983354,1983354,1981793.47863,847966,847311.50204,1135388,1134481.97659
235,2023-11-02,0.99934,10973,4922,6051,1830791,1830791,1829197.98815,887358,886590.1087,943433,942607.87945
236,2023-11-03,0.99922,9287,4779,4508,1409119,1409119,1408095.58099,550654,550249.33642,858465,857846.24457
237,2023-11-04,0.99912,5390,2158,3232,1089861,1089861,1088997.31989,330029,329769.5975,759832,759227.72239
238,2023-11-05,0.99902,9404,4803,4601,1711661,1711661,1709961.41436,839326,838498.02473,872335,871463.38963
239,2023-11-06,0.99931,11489,7692,3797,4358979,4358979,4354818.59362,2816190,2813610.22372,1542789,1541208.3699
240,2023-11-07,0.99929,11395,5957,5438,3439414,3439414,3437865.64058,1750863,1750089.80453,1688551,1687775.83605
241,2023-11-08,0.99922,7492,3998,3494,1470387,1470387,1469378.12591,782226,781678.2888,688161,687699.83711
242,2023-11-09,0.99936,17227,8044,9183,4335268,4335268,4331609.47888,1371008,1369932.43642,2964260,2961677.04246
243,2023-11-10,0.99908,10272,3938,6334,1852295,1852295,1850834.70332,714588,714042.9876,1137707,1136791.71572
244,2023-11-11,0.99928,9163,4719,4444,1726914,1726914,1725399.85924,974677,973799.40321,752237,751600.45603
245,2023-11-12,0.99905,9566,6489,3077,991420,991420,990585.50571,466793,466394.46489,524627,524191.04082
246,2023-11-13,0.9992,11364,7960,3404,1516415,1516415,1515082.83897,819798,819057.69099,696617,696025.14798
247,2023-11-14,0.99943,18407,8967,9440,6568088,6568088,6562821.69535,3642187,3639148.70292,2925901,2923672.99243
248,2023-11-15,0.99907,10590,5487,5103,2459157,2459157,2457412.39898,1243990,1243158.72373,1215167,1214253.67525
249,2023-11-16,0.99933,8300,5149,3151,3567172,3567172,3564297.4888,2056524,2054890.04145,1510648,1509407.44735
250,2023-11-17,0.9992,17353,8962,8391,5513854,5513854,5510574.13747,3035216,3033437.02133,2478638,2477137.11614
251,2023-11-18,0.9991,8752,4705,4047,1949247,1949247,1947610.83185,958970,958176.16562,990277,989434.66623
252,2023-11-19,0.9991,7602,3963,3639,2217882,2217882,2215885.05917,1073696,1072741.53231,1144186,1143143.52686
253,2023-11-20,0.99888,8388,4373,4015,2994077,2994077,2991156.65659,1446754,1445409.62937,1547323,1545747.02722
254,2023-11-21,0.99918,15583,7750,7833,7232411,7232411,7225434.27009,3641523,3638093.48919,3590888,3587340.7809
255,2023-11-22,0.99928,11092,4916,6176,4648277,4648277,4645140.90456,2209755,2208269.98864,2438522,2436870.91592
256,2023-11-23,0.99939,7392,3261,4131,1217641,1217641,1216786.61407,641939,641491.93013,575702,575294.68394
257,2023-11-24,0.99888,8649,4189,4460,4117225,4117225,4113368.04266,1868352,1866627.8463,2248873,2246740.19636
258,2023-11-25,0.99881,7551,3998,3553,2177775,2177775,2175415.70425,1311482,1310053.59221,866293,865362.11204
259,2023-11-26,0.9989,9005,5152,3853,4231103,4231103,4225834.49713,1840882,1838873.34632,2390221,2386961.15081
260,2023-11-27,0.99932,8932,5377,3555,4583242,4583242,4579259.49556,2397683,2395619.97094,2185559,2183639.52462
261,2023-11-28,0.999,11633,5936,5697,4807142,4807142,4802936.41226,2295221,2293214.2568,2511921,2509722.15546
262,2023-11-29,0.99928,9815,5619,4196,3832742,3832742,3828788.39563,1832165,1830273.76153,2000577,1998514.6341
263,2023-11-30,0.99926,6427,3175,3252,2285893,2285893,2284193.35518,1143414,1142566.39862,1142479,1141626.95656
264,2023-12-01,0.99905,7079,2186,4893,2263821,2263821,2261994.91324,985792,984989.2754,1278029,1277005.63784
265,2023-12-02,0.99903,5671,2600,3071,1427093,1427093,1425732.26261,683929,683271.86952,743164,742460.39309
266,2023-12-03,0.99911,6043,3134,2909,1067504,1067504,1066504.75697,533640,533136.56854,533864,533368.18843
267,2023-12-04,0.99941,8925,4563,4362,3113561,3113561,3110993.24986,1483200,1481971.08162,1630361,1629022.16824
268,2023-12-05,0.99926,11148,5868,5280,6010080,6010080,5974619.60442,2244346,2229792.3014,3765734,3744827.30302
269,2023-12-06,0.99943,12760,5072,7688,4849969,4849969,4846996.95293,2466491,2464977.64236,2383478,2382019.31057
270,2023-12-07,0.99932,8450,2950,5500,2272979,2272979,2271681.03032,1291793,1291051.87162,981186,980629.1587
271,2023-12-08,0.99932,7023,3495,3528,1554505,1554505,1553586.13149,791047,790573.9449,763458,763012.18659
272,2023-12-09,0.99914,14627,7849,6778,5999731,5999731,5994520.30946,3116001,3113845.66074,2883730,2880674.64872
273,2023-12-10,0.9994,9676,4601,5075,1473338,1473338,1472321.33304,545610,545225.51902,927728,927095.81402
274,2023-12-11,0.99991,12890,6646,6244,3645654,3645654,3644439.06237,1724684,1724226.5339,1920970,1920212.52847
275,2023-12-12,0.99997,18320,9109,9211,3938014,3938014,3937455.20258,1651425,1651166.46536,2286589,2286288.73722
276,2023-12-13,0.99929,13432,7087,6345,3121351,3121351,3120730.90032,1400077,1399814.85739,1721274,1720916.04293
277,2023-12-14,0.99929,14110,5701,8409,2477188,2477188,2475610.78006,1091524,1090832.99107,1385664,1384777.78899
278,2023-12-15,0.9995,8870,4465,4405,1733456,1733456,1732901.30261,1000665,1000417.9423,732791,732483.36031
279,2023-12-16,1.00031,10585,4212,6373,1823950,1823950,1824114.5437,929539,929604.48609,894411,894510.05761
280,2023-12-17,1.00036,11300,6710,4590,2916392,2916392,2917972.80357,1498056,1498836.80713,1418336,1419135.99644
281,2023-12-18,0.99977,13065,5156,7909,2205726,2205726,2206286.06977,883582,883780.96015,1322144,1322505.10962
282,2023-12-19,0.99984,6995,4135,2860,979182,979182,979105.0253,595266,595217.43982,383916,383887.58548
283,2023-12-20,0.99952,5683,2153,3530,1209856,1209856,1209499.9916,501585,501446.40775,708271,708053.58385
284,2023-12-21,0.99959,2457,759,1698,244993,244993,244886.43051,179104,179027.50516,65889,65858.92535
